10 10 10

OOOOOOOOOO
OOOOOOOOVO
OOOOOOOOOO
OOOOOOOOOO
OOOOOOOOOO
OOOOOOOOOO
OOOOOOOOOO
OOOOOOOOOO
OOOOOOOOOO
OOOOOOOOOO

OOOOOOOOOO
O........O
O........O
O...VOO..O
O........O
O........O
O........O
O........O
Oa......bO
OOOOOOOOOO

OOOOOOOOOO
OOOOOOOOOO
OOOOOOOOOO
OOO...VOOO
OOO....OOO
OOO....OOO
OOO....OOO
OOOOOOOOOO
OOOOOOOOOO
OOOOOOOOOO

OOOOOOOOOO
Oc.......O
O........O
O........O
OdO......O
O..VOO...O
O........O
O...O....O
d...O....O
OOOOOOOOOO

OOOOOOOOOO
O........O
O........O
O........O
O........O
O........O
O...OV...O
O........O
O........O
OOOOOOOOOO

OOOOOOOOOO
O........O
O........O
O........O
O........O
O..O.....O
O..V.....O
O........O
O........O
OOOOOOOOOO

OOOOOOOOOO
O........O
O........O
O..O.....O
O..V.....O
O........O
O........O
O........O
O........O
OOOOOOOOOO

OOOOOOOOOO
O........O
O........O
O...VO...O
O........O
O........O
O........O
O........O
O........O
OOOOOOOOOO

OOOOOOOOOO
O........O
O........O
O.....V..O
O.....O..O
O........O
O........O
O........O
O........O
OOOOOOOOOO

OOOOOOOOOO
OOOOOOOOOO
OOOOOOOOOO
OOOOOOOOOO
OOOOOOOOOO
OOOOOOOOOO
OOOOOOOOOO
OOOOOOOOOO
OOOOOOOOOO
OOOOOOOOOO
